{
	"numTileX": 15,
	"numTileY": 11	,
	"start": [32, 32],
	"size": [64, 64],
	"tileName" : [" ", "tile01", "tile02", "tile03","tile04", "tile05"],
	"tile" : [
			  1, 1, 1, 1, 1, 1, 1, 1, 1, 1, 1, 1, 1, 1, 1, 
			  1, 0, 0, 0, 0, 0, 0, 0, 0, 0, 0, 0, 0, 0, 1, 
			  1, 0, 0, 0, 0, 0, 0, 0, 0, 0, 3, 1, 1, 0, 1,
			  1, 3, 3, 0, 0, 0, 0, 4, 0, 0, 0, 0, 0, 0, 1,
			  1, 0, 0, 0, 0, 0, 2, 2, 2, 0, 0, 0, 0, 0, 1,
			  1, 0, 0, 0, 0, 0, 0, 0, 0, 0, 0, 0, 0, 0, 1,
			  1, 2, 0, 0, 0, 0, 0, 0, 0, 0, 0, 0, 0, 0, 1,
			  1, 0, 2, 2, 5, 0, 0, 0, 0, 3, 3, 5, 3, 0, 1,
			  1, 0, 0, 0, 0, 0, 0, 0, 0, 0, 0, 0, 0, 0, 1,
			  1, 0, 0, 0, 0, 0, 0, 0, 0, 0, 0, 0, 0, 0, 1,
			  1, 1, 1, 1, 1, 4, 3, 3, 1, 1, 1, 1, 1, 1, 1
			  ]
}